{
    "0": 9250,
    "1": 49,
    "2": 50,
    "3": 51,
    "4": 52,
    "5": 53,
    "6": 54,
    "7": 55,
    "8": 56,
    "9": 57,
    "10": 48
}
